21
####E#############
#       ##    ####
# ##### ## ##    #
# ##### ## ## ####
# ##### ## ##    #
#      ### ## ## #
###### ### ## ## #
######     ## ## #
################ #
################ #
#                #
# # # # # # # # ##
# # # # # # # # ##
# # # # # # # # ##
# # # # # # # # ##
#   #   # #   # ##
####### ##########
#####     ########
##### # # ########
#     ###        S
##################